##################################
#....s...#B#.....................#
#........###....##..........##...#
#@.....#......##..........##.....#
#........#.......................#
##################################