##################################
#....s...#B#.....................#
#........###....##..........##...#
#......#......##.....@....##.....#
#........#.......................#
##################################